@charset "utf-8";

// 네이밍 참고
// 아래 단어들을 참고로 조합하여 네이밍 합니다.
// 예) list_tit, mypage_wrap, btn_prev, bu_arrow, box_list, btn_more, step_group




// 영역구분
wrap, area, group, section, container, layout, body
head, footer, article, inner


// 형태
버튼 - btn
박스 - box
블릿 - bu
아이콘 - ico
제목 - title, tit
문장 - txt
이미지 - img, image, images
목록 - list
네비게이션 - gnb, lnb, snb, menu, nav
탭 - tab
테이블 - table, tbl
컨텐츠 - content, cont
팝업 - popup, pop
레이어 - layer
페이지 - page
썸네일 - thumb
라인 - line
점 -  dot
폼 - form


// 의미
읽기 - read
쓰기 - write
수정 - modify
삭제 - del, delete
답변, 답글 - reply
댓글 - comment
취소 - cancel
검색 - search
찾기 - find
등록 - reg, registration
확인 - confirm
전송 - submit
업로드 - upload
다운로드 - download
설치 - install, setup
파일 - file
정지 - stop
실행 - run, play
이전 - prev
다음 - next
위로 - up
아래로 - down
새로고침 - refresh
열기 - open
닫기 - close
확대 - zoom
축소 - reduction
펼치기 - spread
접기 - unfold
잠금 - lock
해제 - unlock
스텝 - step
과정 - process
카운트 - count
마지막 - last, end
처음 - first
로고 - logo
집 - home
체크 - check
상세 - desc, detail
라운드 - round
사각 - square
원형 - circle
화살 - arrow
별 - star
숫자 - num, number
영문 - eng, en, english
한글 - kor, ko, korean
일어 - jp, japanese, jpn
중어 - ch, chinese
신규 - new
업데이트 - update
수평 - h
수직 - v
광고 - ad
강조 - spot, point
좀더 - more
달력 - calender
계산기,계산 - calculator, calc
가리는 영역, 딤드관련 - dimm
링크 - link
그림자 - shadow
순위 - rank, ranking


// 상태
비활성 - off
활성 - on, active
오버 - over
포커스 - focus
체크 - checked
영역 선택 불가 - disabled















